192 13
0 0 0 0 0 0 0 0 0 0 0 0 0 0 0 0 0 0 0 0 0 0 0 0 0 0 0 0 0 0 0 0 0 0 0 0 0 0 0 0 0 0 0 0 0 0 0 0 0 0 0 0 0 0 0 0 0 0 0 0 0 0 0 0 0 0 0 0 0 0 0 0 0 0 0 0 0 0 0 0 0 0 0 0 0 0 0 0 0 0 0 0 0 0 0 0 0 0 0 0 0 0 0 0 0 0 0 0 0 0 0 0 0 0 0 0 0 0 0 0 0 0 0 0 0 0 0 0 0 0 0 0 0 0 0 0 0 0 0 0 0 0 0 0 0 0 0 0 0 0 0 0 0 0 0 0 0 0 0 0 0 0 0 0 0 0 0 0 0 0 0 0 0 0 0 0 0 0 0 0 0 0 0 0 0 0 0 0 0 0 0 0 
0 0 0 0 0 0 0 0 0 0 0 0 0 0 0 0 0 0 0 0 0 0 0 0 0 0 0 0 0 0 0 0 0 0 0 0 0 0 0 0 0 0 0 0 0 0 0 0 0 0 0 0 0 0 0 0 0 0 0 0 0 0 0 0 0 0 0 0 0 0 0 0 0 0 0 0 0 0 0 0 0 0 0 0 0 0 0 0 0 0 0 0 0 0 0 0 0 0 0 0 0 0 0 0 0 0 0 0 0 0 0 0 0 0 0 0 0 0 0 0 0 0 0 0 0 0 0 0 0 0 0 0 0 0 0 0 0 0 0 0 0 0 0 0 0 0 0 0 0 0 0 0 0 0 0 0 0 0 0 0 0 0 0 0 0 0 0 0 0 0 0 0 0 0 0 0 0 0 0 0 0 0 0 0 0 0 0 0 0 0 0 0 
1 1 1 1 1 1 1 1 1 1 1 1 1 1 1 1 2 3 4 5 1 1 1 1 1 1 1 1 1 1 2 3 4 5 1 1 1 1 1 1 1 1 6 7 1 1 1 1 1 1 1 1 1 1 1 1 1 1 2 3 4 5 1 1 1 1 1 1 1 1 1 1 1 1 6 7 1 1 1 1 1 1 1 1 2 3 4 5 1 1 1 1 1 1 1 1 1 1 2 3 4 5 1 1 1 1 1 1 1 1 1 1 1 1 1 1 1 1 1 1 1 1 1 1 1 1 1 1 2 3 4 5 1 1 1 1 1 1 6 7 1 1 1 1 1 1 1 1 1 1 1 1 1 1 1 1 1 1 1 1 1 1 1 1 1 1 1 1 1 1 1 1 1 1 2 3 4 5 1 1 1 1 1 1 1 1 6 7 1 1 8 9 
1 1 1 1 1 1 1 1 1 1 1 1 1 1 1 1 10 11 12 13 1 1 1 1 1 1 1 1 1 1 10 11 12 13 1 1 1 1 1 1 1 1 14 15 1 1 1 1 1 1 1 1 1 1 1 1 1 1 10 11 12 13 1 1 1 1 1 1 1 1 1 1 1 1 14 15 1 1 1 1 1 1 1 1 10 11 12 13 1 1 1 1 1 1 1 1 1 1 10 11 12 13 1 1 1 1 1 1 1 1 1 1 16 4 1 1 1 1 1 1 1 1 1 1 1 1 1 1 10 11 12 13 1 1 1 1 1 1 14 15 1 1 1 1 1 1 1 1 1 1 16 4 1 1 1 1 1 1 1 1 1 1 1 1 1 1 1 1 1 1 1 1 1 1 10 11 12 13 1 1 1 1 1 1 1 1 14 15 1 1 8 17 
1 1 1 1 1 1 1 1 6 7 1 1 1 1 1 1 1 1 1 1 1 1 6 7 1 1 1 1 1 1 1 1 1 1 1 1 18 19 19 19 19 19 19 19 19 20 1 1 1 1 1 1 1 1 6 7 1 1 1 1 1 1 1 1 1 1 1 1 21 19 19 19 19 20 1 1 18 19 19 19 19 20 1 1 1 1 1 1 1 1 1 1 6 7 1 1 1 1 1 1 18 19 19 19 19 19 19 19 19 20 1 1 2 3 4 5 1 1 21 19 19 20 1 1 1 1 1 1 1 1 1 1 1 1 1 1 1 1 1 1 1 1 1 1 1 1 1 1 1 1 2 3 4 5 1 1 1 1 1 1 1 1 1 1 2 3 4 5 1 1 1 1 1 1 1 1 1 1 1 1 1 1 1 1 1 1 1 1 1 1 8 9 
1 1 16 4 1 1 1 1 14 15 1 1 1 1 1 1 1 1 1 1 1 1 14 15 1 1 1 1 1 1 1 1 1 1 1 1 8 22 22 23 22 23 22 23 22 24 1 1 16 4 1 1 1 1 14 15 1 1 1 1 1 1 1 1 1 1 1 1 25 23 22 23 22 24 1 1 8 22 22 23 22 26 1 1 1 1 1 1 1 1 1 1 14 15 1 1 1 1 1 1 8 22 22 23 22 23 22 23 22 24 1 1 10 11 12 13 1 1 25 23 22 24 1 1 1 1 1 1 1 1 1 1 1 1 1 1 1 1 1 1 1 1 16 4 1 1 1 1 1 1 10 11 12 13 1 1 1 1 1 1 1 1 1 1 10 11 12 13 1 1 1 1 1 1 1 1 1 1 1 1 1 1 16 4 1 1 1 1 1 1 8 17 
1 1 2 3 4 5 1 1 1 1 1 1 1 1 1 1 1 1 1 1 1 1 1 1 1 1 18 19 19 19 19 19 19 19 19 19 27 9 17 9 17 9 17 9 17 26 1 1 2 3 4 5 1 1 1 1 1 1 18 20 1 1 6 7 1 1 28 29 25 9 17 9 17 26 1 1 8 9 17 9 17 26 30 19 19 19 19 19 19 19 19 19 19 19 19 19 19 19 19 19 27 9 17 9 17 9 17 9 17 26 1 1 1 1 1 1 28 29 25 9 17 26 1 1 1 1 1 1 1 1 1 1 1 1 18 19 19 19 19 20 1 1 2 3 4 5 1 1 1 1 1 1 1 1 1 1 1 1 6 7 1 1 1 1 1 1 1 1 1 1 18 19 19 19 19 19 19 19 19 20 1 1 2 3 4 5 1 1 1 1 8 9 
1 1 10 11 12 13 1 1 1 1 1 1 16 4 1 1 1 1 1 1 1 1 1 1 1 1 8 22 22 23 22 23 22 23 22 23 9 17 9 17 9 17 9 17 9 26 1 1 10 11 12 13 1 1 1 1 1 1 8 24 1 1 14 15 1 1 1 1 25 17 9 17 9 26 1 1 8 17 9 17 9 17 22 23 22 23 22 23 22 23 22 23 22 23 22 23 22 23 22 23 9 17 9 17 9 17 9 17 9 26 1 1 1 1 1 1 1 1 25 17 9 26 1 1 1 1 1 1 1 1 1 1 1 1 8 22 22 23 22 24 1 1 10 11 12 13 1 1 1 1 1 1 1 1 1 1 1 1 14 15 1 1 1 1 1 1 1 1 1 1 8 22 22 23 22 23 22 23 22 24 1 1 10 11 12 13 1 1 1 1 31 17 
1 1 1 1 1 1 1 1 1 1 1 1 2 3 4 5 18 19 19 19 19 19 19 19 19 19 27 9 17 9 17 9 17 9 17 9 17 9 17 9 17 9 17 9 17 26 1 1 1 1 1 1 1 1 18 20 1 1 8 26 1 1 1 1 1 1 1 1 25 9 17 9 17 9 1 1 17 9 17 9 32 19 19 33 17 9 17 9 17 9 17 9 32 19 19 33 17 9 17 9 17 9 17 9 17 9 17 9 17 34 14 15 35 36 14 15 14 15 25 9 17 26 14 15 18 20 35 36 18 19 19 19 19 19 27 9 17 9 17 26 1 1 1 1 1 1 18 19 19 20 1 1 1 1 1 1 18 19 19 19 19 20 1 1 1 1 18 19 19 19 27 9 17 9 17 9 17 9 17 26 1 1 1 1 1 1 1 1 1 1 37 8 
1 1 1 1 1 1 1 1 1 1 1 1 10 11 12 13 8 22 22 23 22 23 22 23 22 23 9 17 9 17 9 17 9 17 9 17 9 17 9 17 9 17 9 17 9 26 1 1 1 1 1 1 1 1 8 24 1 1 8 26 1 1 1 1 1 1 1 1 38 17 9 17 9 17 1 1 9 17 9 17 39 40 40 40 9 17 9 17 9 17 9 17 39 40 40 40 9 17 9 17 9 17 9 17 9 17 9 17 41 42 42 42 43 44 42 42 42 42 25 17 9 26 42 42 8 24 43 44 8 22 22 23 22 23 9 17 9 17 9 26 1 1 1 1 1 1 8 22 22 26 1 1 1 1 1 1 8 22 22 23 22 26 1 1 1 1 8 22 22 23 9 17 9 17 9 17 9 17 9 26 1 1 1 1 1 1 1 1 1 1 37 8 
19 19 19 19 19 19 19 19 19 19 19 19 19 19 19 19 27 9 17 9 17 9 17 9 17 9 17 9 17 9 17 9 17 9 17 9 17 9 17 9 17 9 17 9 17 26 35 36 14 15 18 20 14 15 8 26 14 15 8 9 30 19 19 19 19 19 19 19 27 9 17 9 32 19 19 19 19 33 17 9 17 9 17 9 17 9 32 19 19 33 17 9 17 9 17 9 17 9 32 19 19 19 19 19 19 33 17 26 45 46 45 46 45 46 18 20 45 46 25 9 17 26 45 46 8 26 45 46 8 9 17 9 17 9 17 9 17 9 17 26 30 19 19 19 19 19 27 9 17 26 30 19 19 19 19 19 27 9 17 9 17 26 30 19 19 19 27 9 17 9 17 9 17 9 17 9 17 9 17 26 35 36 14 15 18 19 19 19 19 19 47 8 
22 23 22 23 22 23 22 23 22 23 22 23 22 23 22 23 9 17 9 17 9 17 9 17 9 17 9 17 9 17 9 17 9 17 9 17 9 17 9 17 9 17 9 17 9 26 43 44 42 42 8 24 42 42 8 26 42 42 8 17 22 23 22 23 22 23 22 23 9 17 9 17 39 40 40 40 40 40 9 17 9 17 9 17 9 17 39 40 40 40 9 17 9 17 9 17 9 17 39 40 40 40 40 40 40 40 9 26 48 48 48 48 48 48 8 24 48 48 38 17 9 26 48 48 8 26 48 48 8 17 9 17 9 17 9 17 9 17 9 17 22 23 22 23 22 23 9 17 9 17 22 23 22 23 22 23 9 17 9 17 9 17 22 23 22 23 9 17 9 17 9 17 9 17 9 17 9 17 9 26 43 44 42 42 8 22 22 23 22 23 40 17 
17 9 17 9 17 9 17 9 17 9 17 9 17 9 17 9 17 9 17 9 17 9 17 9 17 9 17 9 17 9 17 9 17 9 17 9 17 9 17 9 17 9 17 9 17 26 45 46 45 46 8 26 45 46 8 26 45 46 8 9 17 9 17 9 17 9 17 9 17 9 17 9 17 9 17 9 17 9 17 9 17 9 17 9 17 9 17 9 17 9 17 9 17 9 17 9 17 9 17 9 17 9 17 9 17 9 17 26 49 49 49 49 49 49 8 26 49 49 8 9 17 26 49 49 8 26 49 49 8 9 17 9 17 9 17 9 17 9 17 9 17 9 17 9 17 9 17 9 17 9 17 9 17 9 17 9 17 9 17 9 17 9 17 9 17 9 17 9 17 9 17 9 17 9 17 9 17 9 17 26 45 46 45 46 8 9 17 9 17 9 17 9 
