16 13
0 0 0 0 0 0 0 0 0 0 0 0 0 0 0 0 
0 0 0 0 0 0 0 0 0 0 0 0 0 0 0 0 
1 2 3 0 0 4 5 6 7 8 3 0 9 10 7 11 
8 12 0 0 4 13 0 0 8 14 0 0 0 15 7 8 
14 16 17 18 19 20 17 18 5 6 0 19 9 10 7 11 
21 8 0 20 0 0 0 20 0 0 20 20 0 15 7 8 
14 16 0 19 17 18 0 4 19 20 19 20 9 10 7 11 
21 8 0 20 0 20 4 13 0 0 0 0 0 15 7 8 
1 22 23 0 19 20 19 0 17 18 19 0 9 10 7 11 
8 24 25 26 0 0 27 26 0 20 27 26 0 15 7 8 
1 28 29 30 31 31 32 33 31 31 34 30 31 31 7 11 
8 35 36 37 38 37 38 37 38 37 39 37 38 37 7 8 
1 2 8 1 40 21 14 16 40 21 8 1 40 21 14 16 
